****************
*         *    *
*    *    *  ***
*    *    *    *
*    *    *    *
*    *    *E   *
*S   *         *
****************
